departamento,municipio,mujeres,hombres,total,mayoria
AMAZONAS,EL ENCANTO,357,450,807,Hombres
AMAZONAS,LA CHORRERA,502,601,1103,Hombres
AMAZONAS,LA PEDRERA,556,667,1223,Hombres
AMAZONAS,LA VICTORIA,27,47,74,Hombres
AMAZONAS,LETICIA,19934,20354,40288,Hombres
AMAZONAS,MIRITI PARANA,241,320,561,Hombres
AMAZONAS,PUERTO ALEGRIA,131,167,298,Hombres
AMAZONAS,PUERTO ARICA,216,290,506,Hombres
AMAZONAS,PUERTO NARIÑO,2239,2590,4829,Hombres
AMAZONAS,PUERTO SANTANDER,252,353,605,Hombres
AMAZONAS,TARAPACA,694,799,1493,Hombres
ANTIOQUIA,ABEJORRAL,7395,8109,15504,Hombres
ANTIOQUIA,ABRIAQUI,899,1090,1989,Hombres
ANTIOQUIA,ALEJANDRIA,2246,2345,4591,Hombres
ANTIOQUIA,AMAGA,12012,11527,23539,Mujeres
ANTIOQUIA,AMALFI,8930,9511,18441,Hombres
ANTIOQUIA,ANDES,17190,18857,36047,Hombres
ANTIOQUIA,ANGELOPOLIS,2873,3078,5951,Hombres
ANTIOQUIA,ANGOSTURA,4618,4951,9569,Hombres
ANTIOQUIA,ANORI,5844,6864,12708,Hombres
ANTIOQUIA,ANTIOQUIA,10918,11230,22148,Hombres
ANTIOQUIA,ANZA,2963,3337,6300,Hombres
ANTIOQUIA,APARTADO,51540,49368,100908,Mujeres
ANTIOQUIA,ARBOLETES,11515,12173,23688,Hombres
ANTIOQUIA,ARGELIA,3211,3643,6854,Hombres
ANTIOQUIA,ARMENIA,2206,2479,4685,Hombres
ANTIOQUIA,BARBOSA,22733,22218,44951,Mujeres
ANTIOQUIA,BELLO,185292,157959,343251,Mujeres
ANTIOQUIA,BELMIRA,2476,2647,5123,Hombres
ANTIOQUIA,BETANIA,3889,4631,8520,Hombres
ANTIOQUIA,BETULIA,6523,7371,13894,Hombres
ANTIOQUIA,BOLIVAR,11808,12509,24317,Hombres
ANTIOQUIA,BRICEÑO,3074,3861,6935,Hombres
ANTIOQUIA,BURITICA,3486,4045,7531,Hombres
ANTIOQUIA,CACERES,9476,10538,20014,Hombres
ANTIOQUIA,CAICEDO,3174,3648,6822,Hombres
ANTIOQUIA,CALDAS,35033,32717,67750,Mujeres
ANTIOQUIA,CAMPAMENTO,3226,3822,7048,Hombres
ANTIOQUIA,CAÑASGORDAS,6733,7473,14206,Hombres
ANTIOQUIA,CARACOLI,2302,2580,4882,Hombres
ANTIOQUIA,CARAMANTA,2403,2712,5115,Hombres
ANTIOQUIA,CAREPA,22918,23859,46777,Hombres
ANTIOQUIA,CARMEN DE VIBORAL,20259,19620,39879,Mujeres
ANTIOQUIA,CAROLINA,2115,2086,4201,Mujeres
ANTIOQUIA,CAUCASIA,37576,35648,73224,Mujeres
ANTIOQUIA,CHIGORODO,25503,24613,50116,Mujeres
ANTIOQUIA,CISNEROS,5963,6013,11976,Hombres
ANTIOQUIA,COCORNA,6965,7067,14032,Hombres
ANTIOQUIA,CONCEPCION,2131,2221,4352,Hombres
ANTIOQUIA,CONCORDIA,7960,8597,16557,Hombres
ANTIOQUIA,COPACABANA,37345,35443,72788,Mujeres
ANTIOQUIA,DABEIBA,9257,10198,19455,Hombres
ANTIOQUIA,DON MATIAS,9281,8793,18074,Mujeres
ANTIOQUIA,EBEJICO,5490,6064,11554,Hombres
ANTIOQUIA,EL BAGRE,19289,20308,39597,Hombres
ANTIOQUIA,ENTRERRIOS,4347,4918,9265,Hombres
ANTIOQUIA,ENVIGADO,127520,112409,239929,Mujeres
ANTIOQUIA,FREDONIA,8942,9444,18386,Hombres
ANTIOQUIA,FRONTINO,8723,9316,18039,Hombres
ANTIOQUIA,GIRALDO,2239,2359,4598,Hombres
ANTIOQUIA,GIRARDOTA,27101,27275,54376,Hombres
ANTIOQUIA,GOMEZ PLATA,4286,4584,8870,Hombres
ANTIOQUIA,GRANADA,5025,5251,10276,Hombres
ANTIOQUIA,GUADALUPE,2822,3081,5903,Hombres
ANTIOQUIA,GUARNE,18859,18691,37550,Mujeres
ANTIOQUIA,GUATAPE,3739,3639,7378,Mujeres
ANTIOQUIA,HELICONIA,2902,3219,6121,Hombres
ANTIOQUIA,HISPANIA,2558,2740,5298,Hombres
ANTIOQUIA,ITAGUI,138230,122419,260649,Mujeres
ANTIOQUIA,ITUANGO,8299,9969,18268,Hombres
ANTIOQUIA,JARDIN,6363,6483,12846,Hombres
ANTIOQUIA,JERICO,5725,5720,11445,Mujeres
ANTIOQUIA,LA CEJA,27098,25370,52468,Mujeres
ANTIOQUIA,LA ESTRELLA,30964,28832,59796,Mujeres
ANTIOQUIA,LA PINTADA,3617,3678,7295,Hombres
ANTIOQUIA,LA UNION,9152,9215,18367,Hombres
ANTIOQUIA,LIBORINA,4400,5085,9485,Hombres
ANTIOQUIA,MACEO,3755,4231,7986,Hombres
ANTIOQUIA,MARINILLA,23513,22167,45680,Mujeres
ANTIOQUIA,MEDELLIN,949152,794374,1743526,Mujeres
ANTIOQUIA,MONTEBELLO,2977,3448,6425,Hombres
ANTIOQUIA,MURINDO,1542,1671,3213,Hombres
ANTIOQUIA,MUTATA,6962,7185,14147,Hombres
ANTIOQUIA,"NARIÑO",4290,4907,9197,Hombres
ANTIOQUIA,NECHI,9171,10841,20012,Hombres
ANTIOQUIA,NECOCLI,17954,18755,36709,Hombres
ANTIOQUIA,OLAYA,1404,1470,2874,Hombres
ANTIOQUIA,PEÑOL,8705,8548,17253,Mujeres
ANTIOQUIA,PEQUE,3006,3483,6489,Hombres
ANTIOQUIA,PUEBLORRICO,3662,3773,7435,Hombres
ANTIOQUIA,PUERTO BERRIO,17113,18427,35540,Hombres
ANTIOQUIA,PUERTO NARE-LA MAGDALENA,5819,6335,12154,Hombres
ANTIOQUIA,PUERTO TRIUNFO,7126,7612,14738,Hombres
ANTIOQUIA,REMEDIOS,9874,10708,20582,Hombres
ANTIOQUIA,RETIRO,9184,8968,18152,Mujeres
ANTIOQUIA,RIONEGRO,58144,55452,113596,Mujeres
ANTIOQUIA,SABANALARGA,3541,4015,7556,Hombres
ANTIOQUIA,SABANETA,44245,38695,82940,Mujeres
ANTIOQUIA,SALGAR,6789,7463,14252,Hombres
ANTIOQUIA,SAN ANDRES,2694,3004,5698,Hombres
ANTIOQUIA,SAN CARLOS,7070,7805,14875,Hombres
ANTIOQUIA,SAN FRANCISCO,3070,3422,6492,Hombres
ANTIOQUIA,SAN JERONIMO,6267,6633,12900,Hombres
ANTIOQUIA,SAN JOSE DE LA MONTAÑA,1603,1741,3344,Hombres
ANTIOQUIA,SAN JUAN DE URABA,9572,9916,19488,Hombres
ANTIOQUIA,SAN LUIS,5712,6041,11753,Hombres
ANTIOQUIA,SAN PEDRO,10930,11089,22019,Hombres
ANTIOQUIA,SAN PEDRO DE URABA,13472,14557,28029,Hombres
ANTIOQUIA,SAN RAFAEL,6351,6759,13110,Hombres
ANTIOQUIA,SAN ROQUE,7456,8235,15691,Hombres
ANTIOQUIA,SAN VICENTE,8069,8786,16855,Hombres
ANTIOQUIA,SANTA BARBARA,11335,11376,22711,Hombres
ANTIOQUIA,SANTA ROSA DE OSOS,13984,13940,27924,Mujeres
ANTIOQUIA,SANTO DOMINGO,4564,5020,9584,Hombres
ANTIOQUIA,SANTUARIO,14965,13439,28404,Mujeres
ANTIOQUIA,SEGOVIA,14547,14650,29197,Hombres
ANTIOQUIA,SONSON,13732,13888,27620,Hombres
ANTIOQUIA,SOPETRAN,6335,6529,12864,Hombres
ANTIOQUIA,TAMESIS,7356,7553,14909,Hombres
ANTIOQUIA,TARAZA,12351,13422,25773,Hombres
ANTIOQUIA,TARSO,3054,3114,6168,Hombres
ANTIOQUIA,TITIRIBI,4352,4484,8836,Hombres
ANTIOQUIA,TOLEDO,2098,2546,4644,Hombres
ANTIOQUIA,TURBO,48323,44840,93163,Mujeres
ANTIOQUIA,URAMITA,3048,3463,6511,Hombres
ANTIOQUIA,URRAO,12223,12548,24771,Hombres
ANTIOQUIA,VALDIVIA,6035,6591,12626,Hombres
ANTIOQUIA,VALPARAISO,2850,2962,5812,Hombres
ANTIOQUIA,VEGACHI,5544,5752,11296,Hombres
ANTIOQUIA,VENECIA,5818,5682,11500,Mujeres
ANTIOQUIA,VIGIA DEL FUERTE,3027,3188,6215,Hombres
ANTIOQUIA,YALI,2925,3456,6381,Hombres
ANTIOQUIA,YARUMAL,17928,17003,34931,Mujeres
ANTIOQUIA,YOLOMBO,8019,8589,16608,Hombres
ANTIOQUIA,YONDO-CASABE,6638,7948,14586,Hombres
ANTIOQUIA,ZARAGOZA,9990,10644,20634,Hombres
ARAUCA,ARAUCA,39869,39965,79834,Hombres
ARAUCA,ARAUQUITA,15897,18554,34451,Hombres
ARAUCA,CRAVO NORTE,1739,2121,3860,Hombres
ARAUCA,FORTUL,6501,7018,13519,Hombres
ARAUCA,PUERTO RONDON,1745,2187,3932,Hombres
ARAUCA,SARAVENA,19557,19333,38890,Mujeres
ARAUCA,TAME,18282,19801,38083,Hombres
ATLANTICO,BARANOA,25312,24885,50197,Mujeres
ATLANTICO,BARRANQUILLA,595408,537137,1132545,Mujeres
ATLANTICO,CAMPO DE LA CRUZ,11285,11296,22581,Hombres
ATLANTICO,CANDELARIA,6739,6949,13688,Hombres
ATLANTICO,GALAPA,20494,20576,41070,Hombres
ATLANTICO,JUAN DE ACOSTA,8857,9388,18245,Hombres
ATLANTICO,LURUACO,12411,12799,25210,Hombres
ATLANTICO,MALAMBO,44887,42795,87682,Mujeres
ATLANTICO,MANATI,7906,8135,16041,Hombres
ATLANTICO,PALMAR DE VARELA,11322,10883,22205,Mujeres
ATLANTICO,PIOJO,2651,3017,5668,Hombres
ATLANTICO,POLONUEVO,6952,7011,13963,Hombres
ATLANTICO,PONEDERA,9839,10055,19894,Hombres
ATLANTICO,PUERTO COLOMBIA,18056,17665,35721,Mujeres
ATLANTICO,REPELON,10336,10628,20964,Hombres
ATLANTICO,SABANAGRANDE,12726,12597,25323,Mujeres
ATLANTICO,SABANALARGA,37197,35987,73184,Mujeres
ATLANTICO,SANTA LUCIA,6191,6292,12483,Hombres
ATLANTICO,SANTO TOMAS,13613,13576,27189,Mujeres
ATLANTICO,SOLEDAD,169758,147090,316848,Mujeres
ATLANTICO,SUAN,5586,5717,11303,Hombres
ATLANTICO,TUBARA,4819,5295,10114,Hombres
ATLANTICO,USIACURI,4214,4356,8570,Hombres
BOGOTA D.C.,BOGOTA. D.C.,3171467,2796051,5967518,Mujeres
BOLIVAR,ACHI,7794,9871,17665,Hombres
BOLIVAR,ALTOS DEL ROSARIO,3484,4079,7563,Hombres
BOLIVAR,ARENAL,2940,3447,6387,Hombres
BOLIVAR,ARJONA,28761,28098,56859,Mujeres
BOLIVAR,ARROYO HONDO,4446,4907,9353,Hombres
BOLIVAR,BARRANCO DE LOBA,5661,6659,12320,Hombres
BOLIVAR,CALAMAR,9616,10149,19765,Hombres
BOLIVAR,CANTAGALLO,3200,4183,7383,Hombres
BOLIVAR,CARTAGENA,436551,386237,822788,Mujeres
BOLIVAR,CICUCO,5217,5549,10766,Hombres
BOLIVAR,CLEMENCIA,5782,5968,11750,Hombres
BOLIVAR,CORDOBA,6677,7995,14672,Hombres
BOLIVAR,EL CARMEN DE BOLIVAR,27829,31071,58900,Hombres
BOLIVAR,EL GUAMO,3787,4429,8216,Hombres
BOLIVAR,EL PEÑON,2915,3438,6353,Hombres
BOLIVAR,HATILLO DE LOBA,5080,6212,11292,Hombres
BOLIVAR,MAGANGUE,50635,50657,101292,Hombres
BOLIVAR,MAHATES,10436,11051,21487,Hombres
BOLIVAR,MARGARITA,4630,5495,10125,Hombres
BOLIVAR,MARIA LA BAJA,20928,21644,42572,Hombres
BOLIVAR,MOMPOS,18677,19533,38210,Hombres
BOLIVAR,MONTECRISTO,3781,5619,9400,Hombres
BOLIVAR,MORALES,5389,6640,12029,Hombres
BOLIVAR,NOROSI,1889,2564,4453,Hombres
BOLIVAR,PINILLOS,8056,10069,18125,Hombres
BOLIVAR,REGIDOR,2334,2740,5074,Hombres
BOLIVAR,RIOVIEJO,2995,3496,6491,Hombres
BOLIVAR,SAN CRISTOBAL,3758,3868,7626,Hombres
BOLIVAR,SAN ESTANISLAO,7776,8012,15788,Hombres
BOLIVAR,SAN FERNANDO,4297,4988,9285,Hombres
BOLIVAR,SAN JACINTO,10384,11296,21680,Hombres
BOLIVAR,SAN JACINTO DEL CAUCA,3168,4063,7231,Hombres
BOLIVAR,SAN JUAN NEPOMUCENO,15651,16877,32528,Hombres
BOLIVAR,SAN MARTIN DE LOBA,5706,6595,12301,Hombres
BOLIVAR,SAN PABLO,9408,10557,19965,Hombres
BOLIVAR,SANTA CATALINA,6704,6921,13625,Hombres
BOLIVAR,SANTA ROSA,7892,8015,15907,Hombres
BOLIVAR,SANTA ROSA DEL SUR,11214,12811,24025,Hombres
BOLIVAR,SIMITI,5864,7370,13234,Hombres
BOLIVAR,SOPLAVIENTO,4406,4334,8740,Mujeres
BOLIVAR,TALAIGUA NUEVO,4772,5144,9916,Hombres
BOLIVAR,TIQUISIO (PTO. RICO),6252,8033,14285,Hombres
BOLIVAR,TURBACO,35329,35161,70490,Mujeres
BOLIVAR,TURBANA,7520,7985,15505,Hombres
BOLIVAR,VILLANUEVA,8386,8465,16851,Hombres
BOLIVAR,ZAMBRANO,4577,5136,9713,Hombres
BOYACA,ALMEIDA,926,1067,1993,Hombres
BOYACA,AQUITANIA (PUEBLOVIEJO),6372,6664,13036,Hombres
BOYACA,ARCABUCO,2516,2582,5098,Hombres
BOYACA,BELEN,3570,3307,6877,Mujeres
BOYACA,BERBEO,699,734,1433,Hombres
BOYACA,BETEITIVA,956,934,1890,Mujeres
BOYACA,BOAVITA,2519,2574,5093,Hombres
BOYACA,BOYACA,2056,2376,4432,Hombres
BOYACA,BRICEÑO,1057,1292,2349,Hombres
BOYACA,BUENAVISTA,2250,2662,4912,Hombres
BOYACA,BUSBANZA,498,462,960,Mujeres
BOYACA,CALDAS,1550,1641,3191,Hombres
BOYACA,CAMPOHERMOSO,1136,1376,2512,Hombres
BOYACA,CERINZA,1867,1711,3578,Mujeres
BOYACA,CHINAVITA,1498,1592,3090,Hombres
BOYACA,CHIQUINQUIRA,22905,19875,42780,Mujeres
BOYACA,CHIQUIZA,2143,2503,4646,Hombres
BOYACA,CHISCAS,1635,1769,3404,Hombres
BOYACA,CHITA,3031,3277,6308,Hombres
BOYACA,CHITARAQUE,2560,3143,5703,Hombres
BOYACA,CHIVATA,1425,1483,2908,Hombres
BOYACA,CHIVOR,791,1073,1864,Hombres
BOYACA,CIENEGA,1940,1993,3933,Hombres
BOYACA,COMBITA,4747,4791,9538,Hombres
BOYACA,COPER,1456,1791,3247,Hombres
BOYACA,CORRALES,1129,1160,2289,Hombres
BOYACA,COVARACHIA,1437,1740,3177,Hombres
BOYACA,CUBARA,2963,3351,6314,Hombres
BOYACA,CUCAITA,1618,1724,3342,Hombres
BOYACA,CUITIVA,916,906,1822,Mujeres
BOYACA,DUITAMA,49148,42812,91960,Mujeres
BOYACA,EL COCUY,1702,1836,3538,Hombres
BOYACA,EL ESPINO,1156,1166,2322,Hombres
BOYACA,FIRAVITOBA,2734,3262,5996,Hombres
BOYACA,FLORESTA,1724,1528,3252,Mujeres
BOYACA,GACHANTIVA,1387,1642,3029,Hombres
BOYACA,GAMEZA,2058,2054,4112,Mujeres
BOYACA,GARAGOA,6396,5763,12159,Mujeres
BOYACA,GUACAMAYAS,846,811,1657,Mujeres
BOYACA,GUATEQUE,4592,4491,9083,Mujeres
BOYACA,GUAYATA,1881,2004,3885,Hombres
BOYACA,GUICAN,1518,1612,3130,Hombres
BOYACA,IZA,1122,1142,2264,Hombres
BOYACA,JENESANO,2885,3097,5982,Hombres
BOYACA,JERICO,1547,1772,3319,Hombres
BOYACA,LA CAPILLA,1200,1336,2536,Hombres
BOYACA,LA UVITA,1262,1311,2573,Hombres
BOYACA,LA VICTORIA,725,847,1572,Hombres
BOYACA,LABRANZAGRANDE,1387,1648,3035,Hombres
BOYACA,MACANAL,1723,1875,3598,Hombres
BOYACA,MARIPI,2631,3686,6317,Hombres
BOYACA,MIRAFLORES,3774,3877,7651,Hombres
BOYACA,MONGUA,2151,1929,4080,Mujeres
BOYACA,MONGUI,2064,1853,3917,Mujeres
BOYACA,MONIQUIRA,9373,9330,18703,Mujeres
BOYACA,MOTAVITA,2680,2909,5589,Hombres
BOYACA,MUZO,3383,4317,7700,Hombres
BOYACA,NOBSA,6714,6139,12853,Mujeres
BOYACA,NUEVO COLON,2288,2454,4742,Hombres
BOYACA,OICATA,1422,1385,2807,Mujeres
BOYACA,OTANCHE,3148,3656,6804,Hombres
BOYACA,PACHAVITA,942,1045,1987,Hombres
BOYACA,PAEZ,1148,1341,2489,Hombres
BOYACA,PAIPA,14655,13579,28234,Mujeres
BOYACA,PAJARITO,819,905,1724,Hombres
BOYACA,PANQUEBA,801,797,1598,Mujeres
BOYACA,PAUNA,3118,3799,6917,Hombres
BOYACA,PAYA,681,865,1546,Hombres
BOYACA,PAZ DE RIO,2125,2034,4159,Mujeres
BOYACA,PESCA,3189,3316,6505,Hombres
BOYACA,PISBA,532,636,1168,Hombres
BOYACA,PUERTO BOYACA,18691,19216,37907,Hombres
BOYACA,QUIPAMA,2055,3049,5104,Hombres
BOYACA,RAMIRIQUI,4551,4547,9098,Mujeres
BOYACA,RAQUIRA,2403,2614,5017,Hombres
BOYACA,RONDON,1166,1188,2354,Hombres
BOYACA,SABOYA,5061,5319,10380,Hombres
BOYACA,SACHICA,1873,1932,3805,Hombres
BOYACA,SAMACA,7427,7792,15219,Hombres
BOYACA,SAN EDUARDO,707,807,1514,Hombres
BOYACA,SAN JOSE DE PARE,2540,3034,5574,Hombres
BOYACA,SAN LUIS DE GACENO,2012,2284,4296,Hombres
BOYACA,SAN MATEO,1776,1859,3635,Hombres
BOYACA,SAN MIGUEL DE SEMA,1345,1403,2748,Hombres
BOYACA,SAN PABLO DE BORBUR,2397,3389,5786,Hombres
BOYACA,SANTA MARIA,1514,1780,3294,Hombres
BOYACA,SANTA ROSA DE VITERBO,4546,4042,8588,Mujeres
BOYACA,SANTA SOFIA,1507,1576,3083,Hombres
BOYACA,SANTANA,3397,3788,7185,Hombres
BOYACA,SATIVANORTE,1167,1310,2477,Hombres
BOYACA,SATIVASUR,650,579,1229,Mujeres
BOYACA,SIACHOQUE,3058,3317,6375,Hombres
BOYACA,SOATA,3974,3713,7687,Mujeres
BOYACA,SOCHA,3206,3309,6515,Hombres
BOYACA,SOCOTA,2713,3263,5976,Hombres
BOYACA,SOGAMOSO,52075,44870,96945,Mujeres
BOYACA,SOMONDOCO,1347,1429,2776,Hombres
BOYACA,SORA,1353,1416,2769,Hombres
BOYACA,SORACA,2968,3105,6073,Hombres
BOYACA,SOTAQUIRA,2893,3017,5910,Hombres
BOYACA,SUSACON,1254,1361,2615,Hombres
BOYACA,SUTAMARCHAN,2949,2986,5935,Hombres
BOYACA,SUTATENZA,1873,1867,3740,Mujeres
BOYACA,TASCO,2415,2553,4968,Hombres
BOYACA,TENZA,1741,1828,3569,Hombres
BOYACA,TIBANA,3699,3949,7648,Hombres
BOYACA,TIBASOSA,4681,4721,9402,Hombres
BOYACA,TINJACA,1397,1486,2883,Hombres
BOYACA,TIPACOQUE,1680,1864,3544,Hombres
BOYACA,TOCA,3735,3887,7622,Hombres
BOYACA,TOGUI,2023,2404,4427,Hombres
BOYACA,TOPAGA,1700,1586,3286,Mujeres
BOYACA,TOTA,2081,2180,4261,Hombres
BOYACA,TUNJA,70505,59706,130211,Mujeres
BOYACA,TUNUNGUA,652,761,1413,Hombres
BOYACA,TURMEQUE,2839,2914,5753,Hombres
BOYACA,TUTA,4068,4024,8092,Mujeres
BOYACA,TUTAZA,1026,959,1985,Mujeres
BOYACA,UMBITA,2698,3133,5831,Hombres
BOYACA,VENTAQUEMADA,5888,5827,11715,Mujeres
BOYACA,VILLA DE LEIVA,6543,6033,12576,Mujeres
BOYACA,VIRACACHA,1206,1367,2573,Hombres
BOYACA,ZETAQUIRA,2158,2233,4391,Hombres
CALDAS,AGUADAS,9392,9670,19062,Hombres
CALDAS,ANSERMA,14299,14300,28599,Hombres
CALDAS,ARANZAZU,5506,5788,11294,Hombres
CALDAS,BELALCAZAR,4870,5494,10364,Hombres
CALDAS,CHINCHINA,23886,22742,46628,Mujeres
CALDAS,FILADELFIA,4536,4892,9428,Hombres
CALDAS,LA DORADA,30164,27476,57640,Mujeres
CALDAS,LA MERCED,2702,2912,5614,Hombres
CALDAS,MANIZALES,179848,158753,338601,Mujeres
CALDAS,MANZANARES,7525,8232,15757,Hombres
CALDAS,MARMATO,3459,3856,7315,Hombres
CALDAS,MARQUETALIA,5553,6230,11783,Hombres
CALDAS,MARULANDA,1125,1376,2501,Hombres
CALDAS,NEIRA,9701,10271,19972,Hombres
CALDAS,NORCASIA,3095,3396,6491,Hombres
CALDAS,PACORA,5875,6179,12054,Hombres
CALDAS,PALESTINA,7126,8050,15176,Hombres
CALDAS,PENSILVANIA,7963,8820,16783,Hombres
CALDAS,RIOSUCIO,20438,19771,40209,Mujeres
CALDAS,RISARALDA,4897,5790,10687,Hombres
CALDAS,SALAMINA,7474,7784,15258,Hombres
CALDAS,SAMANA,7632,8762,16394,Hombres
CALDAS,SAN JOSE,2335,2654,4989,Hombres
CALDAS,SUPIA,11911,11262,23173,Mujeres
CALDAS,VICTORIA,4066,4390,8456,Hombres
CALDAS,VILLAMARIA,22459,20491,42950,Mujeres
CALDAS,VITERBO,6657,6553,13210,Mujeres
CAQUETA,ALBANIA,1987,2209,4196,Hombres
CAQUETA,BELEN DE LOS ANDAQUIES,3992,4296,8288,Hombres
CAQUETA,CARTAGENA DEL CHAIRA,9615,11795,21410,Hombres
CAQUETA,CURILLO,3664,4088,7752,Hombres
CAQUETA,EL DONCELLO,7992,8201,16193,Hombres
CAQUETA,EL PAUJIL,5827,6214,12041,Hombres
CAQUETA,FLORENCIA,67795,60911,128706,Mujeres
CAQUETA,LA MONTAÑITA,5532,7019,12551,Hombres
CAQUETA,MILAN,3035,3773,6808,Hombres
CAQUETA,MORELIA,1863,2236,4099,Hombres
CAQUETA,PUERTO RICO,9484,10486,19970,Hombres
CAQUETA,SAN JOSE DEL FRAGUA,4882,5343,10225,Hombres
CAQUETA,SAN VICENTE DEL CAGUAN,17462,19656,37118,Hombres
CAQUETA,SOLANO,3594,4912,8506,Hombres
CAQUETA,SOLITA,2840,3146,5986,Hombres
CAQUETA,VALPARAISO,2746,3307,6053,Hombres
CASANARE,AGUAZUL,14524,14808,29332,Hombres
CASANARE,CHAMEZA,868,981,1849,Hombres
CASANARE,HATO COROZAL,3496,4105,7601,Hombres
CASANARE,LA SALINA,426,473,899,Hombres
CASANARE,MANI,5316,5984,11300,Hombres
CASANARE,MONTERREY,6148,6088,12236,Mujeres
CASANARE,NUNCHIA,3037,3526,6563,Hombres
CASANARE,OROCUE,3896,4445,8341,Hombres
CASANARE,PAZ DE ARIPORO (MORENO),13041,13438,26479,Hombres
CASANARE,PORE,3901,4000,7901,Hombres
CASANARE,RECETOR,556,667,1223,Hombres
CASANARE,SABANALARGA,1339,1426,2765,Hombres
CASANARE,SACAMA,728,897,1625,Hombres
CASANARE,SAN LUIS DE PALENQUE,2974,3371,6345,Hombres
CASANARE,TAMARA,2135,2476,4611,Hombres
CASANARE,TAURAMENA,8874,9738,18612,Hombres
CASANARE,TRINIDAD,4689,5087,9776,Hombres
CASANARE,VILLANUEVA,12371,12802,25173,Hombres
CASANARE,YOPAL,61886,59188,121074,Mujeres
CAUCA,ALMAGUER,6431,6607,13038,Hombres
CAUCA,ARGELIA,9611,11133,20744,Hombres
CAUCA,BALBOA,8140,8503,16643,Hombres
CAUCA,BOLIVAR,15097,15887,30984,Hombres
CAUCA,BUENOS AIRES,8857,8723,17580,Mujeres
CAUCA,CAJIBIO,12317,13456,25773,Hombres
CAUCA,CALDONO,12016,12401,24417,Hombres
CAUCA,CALOTO,10095,9832,19927,Mujeres
CAUCA,CORINTO,9775,9013,18788,Mujeres
CAUCA,EL TAMBO,17196,19368,36564,Hombres
CAUCA,FLORENCIA,2313,2539,4852,Hombres
CAUCA,GUACHENE,7803,6308,14111,Mujeres
CAUCA,GUAPI,9668,9498,19166,Mujeres
CAUCA,INZA,8934,9353,18287,Hombres
CAUCA,JAMBALO,4744,4832,9576,Hombres
CAUCA,LA SIERRA,4407,4833,9240,Hombres
CAUCA,LA VEGA,7549,8085,15634,Hombres
CAUCA,LOPEZ (MICAY),6419,7132,13551,Hombres
CAUCA,MERCADERES,7001,7306,14307,Hombres
CAUCA,MIRANDA,11263,10067,21330,Mujeres
CAUCA,MORALES,10093,11015,21108,Hombres
CAUCA,PADILLA,3784,3378,7162,Mujeres
CAUCA,PAEZ (BELALCAZAR),10374,11093,21467,Hombres
CAUCA,PATIA (EL BORDO),13457,13036,26493,Mujeres
CAUCA,PIAMONTE,2706,3345,6051,Hombres
CAUCA,PIENDAMO,15455,14961,30416,Mujeres
CAUCA,POPAYAN,134027,117290,251317,Mujeres
CAUCA,PUERTO TEJADA,19037,15131,34168,Mujeres
CAUCA,PURACE (COCONUCO),4933,4697,9630,Mujeres
CAUCA,ROSAS,4260,4676,8936,Hombres
CAUCA,SAN SEBASTIAN,3651,3732,7383,Hombres
CAUCA,SANTA ROSA,1895,2183,4078,Hombres
CAUCA,SANTANDER DE QUILICHAO,42598,38659,81257,Mujeres
CAUCA,SILVIA,11974,11676,23650,Mujeres
CAUCA,SOTARA (PAISPAMBA),3701,3765,7466,Hombres
CAUCA,SUAREZ,8438,9134,17572,Hombres
CAUCA,SUCRE,2959,3015,5974,Hombres
CAUCA,TIMBIO,14000,13457,27457,Mujeres
CAUCA,TIMBIQUI,7660,8037,15697,Hombres
CAUCA,TORIBIO,9919,9988,19907,Hombres
CAUCA,TOTORO,6423,6099,12522,Mujeres
CAUCA,VILLA RICA,8080,6807,14887,Mujeres
CESAR,AGUACHICA,38310,35888,74198,Mujeres
CESAR,AGUSTIN CODAZZI,25084,26265,51349,Hombres
CESAR,ASTREA,7620,8509,16129,Hombres
CESAR,BECERRIL,8210,9244,17454,Hombres
CESAR,BOSCONIA,15141,15739,30880,Hombres
CESAR,CHIMICHAGUA,12192,13241,25433,Hombres
CESAR,CHIRIGUANA,11762,11943,23705,Hombres
CESAR,CURUMANI,14532,14847,29379,Hombres
CESAR,EL COPEY,12067,12541,24608,Hombres
CESAR,EL PASO,12473,12881,25354,Hombres
CESAR,GAMARRA,5325,5692,11017,Hombres
CESAR,GONZALEZ,2103,2402,4505,Hombres
CESAR,LA GLORIA,5355,5787,11142,Hombres
CESAR,LA JAGUA DE IBIRICO,14861,15599,30460,Hombres
CESAR,LA PAZ,10640,11146,21786,Hombres
CESAR,MANAURE BALCON DEL CESAR (MANA,4176,4416,8592,Hombres
CESAR,PAILITAS,7751,7956,15707,Hombres
CESAR,PELAYA,7755,7972,15727,Hombres
CESAR,PUEBLO BELLO,9975,10981,20956,Hombres
CESAR,RIO DE ORO,7696,9086,16782,Hombres
CESAR,SAN ALBERTO,9589,10139,19728,Hombres
CESAR,SAN DIEGO,7665,7776,15441,Hombres
CESAR,SAN MARTIN,8485,9411,17896,Hombres
CESAR,TAMALAMEQUE,5372,5665,11037,Hombres
CESAR,VALLEDUPAR,173599,155565,329164,Mujeres
CHOCO,ACANDI,4703,4974,9677,Hombres
CHOCO,ALTO BAUDO (PIE DE PATO),5118,5453,10571,Hombres
CHOCO,ATRATO (YUTO),4043,3657,7700,Mujeres
CHOCO,BAGADO,4103,4256,8359,Hombres
CHOCO,BAHIA SOLANO (MUTIS),4111,4290,8401,Hombres
CHOCO,BAJO BAUDO (PIZARRO),5388,6121,11509,Hombres
CHOCO,BOJAYA (BELLAVISTA),3735,4118,7853,Hombres
CHOCO,CARMEN DEL DARIEN,3059,3766,6825,Hombres
CHOCO,CERTEGUI,2411,2124,4535,Mujeres
CHOCO,CONDOTO,5652,5230,10882,Mujeres
CHOCO,EL CANTON DEL SAN PABLO (MAN.,2602,2478,5080,Mujeres
CHOCO,EL CARMEN,3354,3354,6708,Hombres
CHOCO,EL LITORAL DEL SAN JUAN,3910,4441,8351,Hombres
CHOCO,ISTMINA,11572,10944,22516,Mujeres
CHOCO,JURADO,1598,1924,3522,Hombres
CHOCO,LLORO,4144,4178,8322,Hombres
CHOCO,MEDIO ATRATO (BETE),3233,3329,6562,Hombres
CHOCO,MEDIO BAUDO (PUERTO MELUK),4218,4529,8747,Hombres
CHOCO,MEDIO SAN JUAN,3862,3954,7816,Hombres
CHOCO,NOVITA,2729,2968,5697,Hombres
CHOCO,NUQUI,2975,3308,6283,Hombres
CHOCO,QUIBDO,49834,39171,89005,Mujeres
CHOCO,RIO IRO,2098,2284,4382,Hombres
CHOCO,RIO QUITO (PAIMADO),3537,3162,6699,Mujeres
CHOCO,RIOSUCIO,9931,11650,21581,Hombres
CHOCO,SAN JOSE DEL PALMAR,1868,2387,4255,Hombres
CHOCO,SIPI,1322,1576,2898,Hombres
CHOCO,TADO,7129,6645,13774,Mujeres
CHOCO,UNGUIA,4160,4821,8981,Hombres
CHOCO,UNION PANAMERICANA (LAS ANIMAS,2837,2728,5565,Mujeres
CONSULADOS,ALEMANIA,4826,3810,8636,Mujeres
CONSULADOS,ARGELIA,9,9,18,Hombres
CONSULADOS,ARGENTINA,7752,6554,14306,Mujeres
CONSULADOS,ARUBA,3005,1862,4867,Mujeres
CONSULADOS,ARZERBAIYAN,14,16,30,Hombres
CONSULADOS,AUSTRALIA,7629,6507,14136,Mujeres
CONSULADOS,AUSTRIA,694,598,1292,Mujeres
CONSULADOS,BELGICA,1810,1270,3080,Mujeres
CONSULADOS,BOLIVIA,511,627,1138,Hombres
CONSULADOS,BRASIL,2260,2969,5229,Hombres
CONSULADOS,CANADA,20013,18464,38477,Mujeres
CONSULADOS,CHILE,11265,9799,21064,Mujeres
CONSULADOS,CHINA REPUBLICA POPULAR,370,433,803,Hombres
CONSULADOS,COREA DEL SUR,151,96,247,Mujeres
CONSULADOS,COSTA RICA,4686,4785,9471,Hombres
CONSULADOS,CUBA,219,206,425,Mujeres
CONSULADOS,CURAZAO,1201,783,1984,Mujeres
CONSULADOS,DINAMARCA,194,140,334,Mujeres
CONSULADOS,ECUADOR,17833,16717,34550,Mujeres
CONSULADOS,EGIPTO,94,79,173,Mujeres
CONSULADOS,EL SALVADOR,316,308,624,Mujeres
CONSULADOS,EMIRATOS ARABES UNIDOS,548,1539,2087,Hombres
CONSULADOS,ESPAÑA,80370,65825,146195,Mujeres
CONSULADOS,ESTADOS UNIDOS,162797,131454,294251,Mujeres
CONSULADOS,FINLANDIA,156,174,330,Hombres
CONSULADOS,FRANCIA,8592,6309,14901,Mujeres
CONSULADOS,GHANA,25,12,37,Mujeres
CONSULADOS,GUATEMALA,805,701,1506,Mujeres
CONSULADOS,HONDURAS,247,268,515,Hombres
CONSULADOS,HUNGRIA,104,92,196,Mujeres
CONSULADOS,INDIA,45,21,66,Mujeres
CONSULADOS,INDONESIA,47,40,87,Mujeres
CONSULADOS,INGLATERRA,8856,7037,15893,Mujeres
CONSULADOS,IRLANDA,214,125,339,Mujeres
CONSULADOS,ISRAEL,791,592,1383,Mujeres
CONSULADOS,ITALIA,5959,4198,10157,Mujeres
CONSULADOS,JAMAICA,161,98,259,Mujeres
CONSULADOS,JAPON,574,468,1042,Mujeres
CONSULADOS,KENIA,44,39,83,Mujeres
CONSULADOS,LIBANO,564,496,1060,Mujeres
CONSULADOS,LUXEMBURGO,88,61,149,Mujeres
CONSULADOS,MALASIA,75,59,134,Mujeres
CONSULADOS,MARRUECOS,29,9,38,Mujeres
CONSULADOS,MEXICO,6458,5151,11609,Mujeres
CONSULADOS,NICARAGUA,143,147,290,Hombres
CONSULADOS,NORUEGA,320,256,576,Mujeres
CONSULADOS,NUEVA ZELANDIA,727,548,1275,Mujeres
CONSULADOS,PAISES BAJOS,2252,1471,3723,Mujeres
CONSULADOS,PANAMA,11319,9500,20819,Mujeres
CONSULADOS,PARAGUAY,215,261,476,Hombres
CONSULADOS,PERU,3185,2726,5911,Mujeres
CONSULADOS,POLONIA,137,229,366,Hombres
CONSULADOS,PORTUGAL,575,396,971,Mujeres
CONSULADOS,PUERTO RICO,893,718,1611,Mujeres
CONSULADOS,REPUBLICA DE FILIPINAS,72,61,133,Mujeres
CONSULADOS,REPUBLICA DE SINGAPUR,146,111,257,Mujeres
CONSULADOS,REPUBLICA DOMINICANA,1337,1343,2680,Hombres
CONSULADOS,REPUBLICA SOCIALISTA DEVIETNAM,24,28,52,Hombres
CONSULADOS,RUSIA,271,370,641,Hombres
CONSULADOS,SUDAFRICA,111,85,196,Mujeres
CONSULADOS,SUECIA,1309,1169,2478,Mujeres
CONSULADOS,SUIZA,3659,2309,5968,Mujeres
CONSULADOS,TAILANDIA,45,54,99,Hombres
CONSULADOS,TRINIDAD Y TOBAGO,126,101,227,Mujeres
CONSULADOS,TURQUIA,178,69,247,Mujeres
CONSULADOS,URUGUAY,499,347,846,Mujeres
CONSULADOS,VENEZUELA,100341,95182,195523,Mujeres
CORDOBA,AYAPEL,16423,18086,34509,Hombres
CORDOBA,BUENAVISTA,8655,9465,18120,Hombres
CORDOBA,CANALETE,7901,8965,16866,Hombres
CORDOBA,CERETE,39293,37100,76393,Mujeres
CORDOBA,CHIMA,6187,6943,13130,Hombres
CORDOBA,CHINU,18833,19620,38453,Hombres
CORDOBA,CIENAGA DE ORO,23089,23536,46625,Hombres
CORDOBA,COTORRA (BONGO),7868,7881,15749,Hombres
CORDOBA,LA APARTADA (FRONTERA),6063,6467,12530,Hombres
CORDOBA,LORICA,46364,44974,91338,Mujeres
CORDOBA,LOS CORDOBAS,7395,8088,15483,Hombres
CORDOBA,MOMIL,7374,7347,14721,Mujeres
CORDOBA,MOÑITOS,9894,10354,20248,Hombres
CORDOBA,MONTELIBANO,30706,30105,60811,Mujeres
CORDOBA,MONTERIA,183949,165171,349120,Mujeres
CORDOBA,PLANETA RICA,27962,27648,55610,Mujeres
CORDOBA,PUEBLO NUEVO,12472,13345,25817,Hombres
CORDOBA,PUERTO ESCONDIDO,8964,9946,18910,Hombres
CORDOBA,PUERTO LIBERTADOR,13956,15919,29875,Hombres
CORDOBA,PURISIMA,6964,7339,14303,Hombres
CORDOBA,SAHAGUN,41067,41071,82138,Hombres
CORDOBA,SAN ANDRES DE SOTAVENTO,14555,15915,30470,Hombres
CORDOBA,SAN ANTERO,11905,11490,23395,Mujeres
CORDOBA,SAN BERNARDO DEL VIENTO,13458,14506,27964,Hombres
CORDOBA,SAN CARLOS,9840,10623,20463,Hombres
CORDOBA,SAN JOSE DE URE,3659,4200,7859,Hombres
CORDOBA,SAN PELAYO,18492,19026,37518,Hombres
CORDOBA,TIERRALTA,33800,34996,68796,Hombres
CORDOBA,TUCHIN,12373,12816,25189,Hombres
CORDOBA,VALENCIA,13295,14092,27387,Hombres
CUNDINAMARCA,AGUA DE DIOS,5266,4801,10067,Mujeres
CUNDINAMARCA,ALBAN,2588,2756,5344,Hombres
CUNDINAMARCA,ANAPOIMA,6121,6375,12496,Hombres
CUNDINAMARCA,ANOLAIMA,5738,6264,12002,Hombres
CUNDINAMARCA,APULO,3430,3797,7227,Hombres
CUNDINAMARCA,ARBELAEZ,4747,4766,9513,Hombres
CUNDINAMARCA,BELTRAN,1058,1184,2242,Hombres
CUNDINAMARCA,BITUIMA,1261,1637,2898,Hombres
CUNDINAMARCA,BOJACA,3461,3401,6862,Mujeres
CUNDINAMARCA,CABRERA,1674,2047,3721,Hombres
CUNDINAMARCA,CACHIPAY,4623,4999,9622,Hombres
CUNDINAMARCA,CAJICA,29079,26140,55219,Mujeres
CUNDINAMARCA,CAPARRAPI,4835,5960,10795,Hombres
CUNDINAMARCA,CAQUEZA,7325,7662,14987,Hombres
CUNDINAMARCA,CARMEN DE CARUPA,2954,3370,6324,Hombres
CUNDINAMARCA,CHAGUANI,1713,2182,3895,Hombres
CUNDINAMARCA,CHIA,54283,49391,103674,Mujeres
CUNDINAMARCA,CHIPAQUE,3845,4227,8072,Hombres
CUNDINAMARCA,CHOACHI,5685,5918,11603,Hombres
CUNDINAMARCA,CHOCONTA,8050,7973,16023,Mujeres
CUNDINAMARCA,COGUA,7927,7744,15671,Mujeres
CUNDINAMARCA,COTA,14328,14048,28376,Mujeres
CUNDINAMARCA,CUCUNUBA,2481,2608,5089,Hombres
CUNDINAMARCA,EL COLEGIO,10932,11094,22026,Hombres
CUNDINAMARCA,EL PEÑON,2036,2482,4518,Hombres
CUNDINAMARCA,EL ROSAL,8905,8908,17813,Hombres
CUNDINAMARCA,FACATATIVA,50999,46857,97856,Mujeres
CUNDINAMARCA,FOMEQUE,4811,5135,9946,Hombres
CUNDINAMARCA,FOSCA,2617,3008,5625,Hombres
CUNDINAMARCA,FUNZA,38632,35185,73817,Mujeres
CUNDINAMARCA,FUQUENE,2098,2048,4146,Mujeres
CUNDINAMARCA,FUSAGASUGA,57512,52935,110447,Mujeres
CUNDINAMARCA,GACHALA,2354,2940,5294,Hombres
CUNDINAMARCA,GACHANCIPA,5709,5619,11328,Mujeres
CUNDINAMARCA,GACHETA,4482,4693,9175,Hombres
CUNDINAMARCA,GAMA,1500,1631,3131,Hombres
CUNDINAMARCA,GIRARDOT,45516,40406,85922,Mujeres
CUNDINAMARCA,GRANADA,3123,3195,6318,Hombres
CUNDINAMARCA,GUACHETA,4523,4664,9187,Hombres
CUNDINAMARCA,GUADUAS,11311,11567,22878,Hombres
CUNDINAMARCA,GUASCA,5720,5927,11647,Hombres
CUNDINAMARCA,GUATAQUI,1256,1396,2652,Hombres
CUNDINAMARCA,GUATAVITA,2620,2792,5412,Hombres
CUNDINAMARCA,GUAYABAL DE SIQUIMA,1976,2071,4047,Hombres
CUNDINAMARCA,GUAYABETAL,2296,2459,4755,Hombres
CUNDINAMARCA,GUTIERREZ,1317,1478,2795,Hombres
CUNDINAMARCA,JERUSALEN,1185,1534,2719,Hombres
CUNDINAMARCA,JUNIN,2750,2736,5486,Mujeres
CUNDINAMARCA,LA CALERA,12125,12132,24257,Hombres
CUNDINAMARCA,LA MESA,13055,13012,26067,Mujeres
CUNDINAMARCA,LA PALMA,4164,4666,8830,Hombres
CUNDINAMARCA,LA PEÑA,2616,3470,6086,Hombres
CUNDINAMARCA,LA VEGA,6828,6988,13816,Hombres
CUNDINAMARCA,LENGUAZAQUE,3360,3795,7155,Hombres
CUNDINAMARCA,MACHETA,2990,3455,6445,Hombres
CUNDINAMARCA,MADRID,38283,35276,73559,Mujeres
CUNDINAMARCA,MANTA,2005,2202,4207,Hombres
CUNDINAMARCA,MEDINA,3211,3737,6948,Hombres
CUNDINAMARCA,MOSQUERA,43005,37705,80710,Mujeres
CUNDINAMARCA,"NARIÑO",1326,1484,2810,Hombres
CUNDINAMARCA,NEMOCON,5234,5271,10505,Hombres
CUNDINAMARCA,NILO,2941,3415,6356,Hombres
CUNDINAMARCA,NIMAIMA,1479,1785,3264,Hombres
CUNDINAMARCA,NOCAIMA,2548,2828,5376,Hombres
CUNDINAMARCA,PACHO,11142,11391,22533,Hombres
CUNDINAMARCA,PAIME,2268,2728,4996,Hombres
CUNDINAMARCA,PANDI,1910,2231,4141,Hombres
CUNDINAMARCA,PARATEBUENO (LA NAGUAYA),3460,4139,7599,Hombres
CUNDINAMARCA,PASCA,3909,4322,8231,Hombres
CUNDINAMARCA,PUERTO SALGAR,6620,6837,13457,Hombres
CUNDINAMARCA,PULI,1291,1613,2904,Hombres
CUNDINAMARCA,QUEBRADANEGRA,1998,2250,4248,Hombres
CUNDINAMARCA,QUETAME,2772,3017,5789,Hombres
CUNDINAMARCA,QUIPILE,2711,3430,6141,Hombres
CUNDINAMARCA,RICAURTE,5329,5564,10893,Hombres
CUNDINAMARCA,SAN ANTONIO DEL TEQUENDAMA,4442,4582,9024,Hombres
CUNDINAMARCA,SAN BERNARDO,3790,4218,8008,Hombres
CUNDINAMARCA,SAN CAYETANO,2004,2522,4526,Hombres
CUNDINAMARCA,SAN FRANCISCO,4547,4663,9210,Hombres
CUNDINAMARCA,SAN JUAN DE RIOSECO,4391,4951,9342,Hombres
CUNDINAMARCA,SASAIMA,4409,4759,9168,Hombres
CUNDINAMARCA,SESQUILE,4420,4488,8908,Hombres
CUNDINAMARCA,SIBATE,13718,13269,26987,Mujeres
CUNDINAMARCA,SILVANIA,9116,9298,18414,Hombres
CUNDINAMARCA,SIMIJACA,4944,4765,9709,Mujeres
CUNDINAMARCA,SOACHA,153871,124985,278856,Mujeres
CUNDINAMARCA,SOPO,10032,9591,19623,Mujeres
CUNDINAMARCA,SUBACHOQUE,6197,6336,12533,Hombres
CUNDINAMARCA,SUESCA,5748,5453,11201,Mujeres
CUNDINAMARCA,SUPATA,2141,2303,4444,Hombres
CUNDINAMARCA,SUSA,2590,2784,5374,Hombres
CUNDINAMARCA,SUTATAUSA,1958,2051,4009,Hombres
CUNDINAMARCA,TABIO,8814,8609,17423,Mujeres
CUNDINAMARCA,TAUSA,2813,3223,6036,Hombres
CUNDINAMARCA,TENA,3475,3701,7176,Hombres
CUNDINAMARCA,TENJO,8518,8224,16742,Mujeres
CUNDINAMARCA,TIBACUY,1963,2133,4096,Hombres
CUNDINAMARCA,TIBIRITA,1455,1614,3069,Hombres
CUNDINAMARCA,TOCAIMA,6605,6705,13310,Hombres
CUNDINAMARCA,TOCANCIPA,15898,15212,31110,Mujeres
CUNDINAMARCA,TOPAIPI,2031,2431,4462,Hombres
CUNDINAMARCA,UBALA,3849,4897,8746,Hombres
CUNDINAMARCA,UBAQUE,2788,3213,6001,Hombres
CUNDINAMARCA,UBATE,17622,16771,34393,Mujeres
CUNDINAMARCA,UNE,3192,3517,6709,Hombres
CUNDINAMARCA,UTICA,2243,2637,4880,Hombres
CUNDINAMARCA,VENECIA,1817,2021,3838,Hombres
CUNDINAMARCA,VERGARA,3306,3917,7223,Hombres
CUNDINAMARCA,VIANI,1889,2179,4068,Hombres
CUNDINAMARCA,VILLAGOMEZ,1030,1153,2183,Hombres
CUNDINAMARCA,VILLAPINZON,6713,7054,13767,Hombres
CUNDINAMARCA,VILLETA,11809,12054,23863,Hombres
CUNDINAMARCA,VIOTA,5342,5798,11140,Hombres
CUNDINAMARCA,YACOPI,5058,6139,11197,Hombres
CUNDINAMARCA,ZIPACON,2107,2228,4335,Hombres
CUNDINAMARCA,ZIPAQUIRA,50721,46266,96987,Mujeres
GUAINIA,BARRANCOMINAS,1795,2272,4067,Hombres
GUAINIA,CACAHUAL,124,152,276,Hombres
GUAINIA,INIRIDA,11809,12744,24553,Hombres
GUAINIA,LA GUADALUPE,88,110,198,Hombres
GUAINIA,MORICHAL (MORICHAL NUEVO),90,115,205,Hombres
GUAINIA,PANA PANA (CAMPO ALEGRE),220,248,468,Hombres
GUAINIA,PUERTO COLOMBIA,581,685,1266,Hombres
GUAINIA,SAN FELIPE,389,472,861,Hombres
GUAVIARE,CALAMAR,2567,4100,6667,Hombres
GUAVIARE,EL RETORNO,4105,5840,9945,Hombres
GUAVIARE,MIRAFLORES,1253,2767,4020,Hombres
GUAVIARE,SAN JOSE DEL GUAVIARE,20704,23374,44078,Hombres
HUILA,ACEVEDO,10037,11313,21350,Hombres
HUILA,AGRADO,3863,3864,7727,Hombres
HUILA,AIPE,7792,7977,15769,Hombres
HUILA,ALGECIRAS,8251,8823,17074,Hombres
HUILA,ALTAMIRA,1688,1696,3384,Hombres
HUILA,BARAYA,2933,3404,6337,Hombres
HUILA,CAMPOALEGRE,13106,12598,25704,Mujeres
HUILA,COLOMBIA,2953,3729,6682,Hombres
HUILA,ELIAS,1693,1858,3551,Hombres
HUILA,GARZON,28114,27802,55916,Mujeres
HUILA,GIGANTE,9657,10175,19832,Hombres
HUILA,GUADALUPE,6617,7273,13890,Hombres
HUILA,HOBO,3029,3027,6056,Mujeres
HUILA,IQUIRA,3682,4026,7708,Hombres
HUILA,ISNOS,10084,10655,20739,Hombres
HUILA,LA ARGENTINA (PLATA VIEJA),5740,6273,12013,Hombres
HUILA,LA PLATA,21999,21949,43948,Mujeres
HUILA,"NATAGA",2436,2723,5159,Hombres
HUILA,NEIVA,150107,132017,282124,Mujeres
HUILA,OPORAPA,3975,4368,8343,Hombres
HUILA,PAICOL,2572,2721,5293,Hombres
HUILA,PALERMO,10525,10844,21369,Hombres
HUILA,PALESTINA,4510,5076,9586,Hombres
HUILA,PITAL,4839,5224,10063,Hombres
HUILA,PITALITO,52813,51458,104271,Mujeres
HUILA,RIVERA,9073,9134,18207,Hombres
HUILA,SALADOBLANCO,4669,5149,9818,Hombres
HUILA,SAN AGUSTIN,12733,13100,25833,Hombres
HUILA,SANTA MARIA,4001,4620,8621,Hombres
HUILA,SUAZA,6834,7607,14441,Hombres
HUILA,TARQUI,6198,6410,12608,Hombres
HUILA,TELLO,5169,5967,11136,Hombres
HUILA,TERUEL,3261,3607,6868,Hombres
HUILA,TESALIA (CARNICERIAS),4085,4184,8269,Hombres
HUILA,TIMANA,8112,8551,16663,Hombres
HUILA,VILLAVIEJA,3249,3472,6721,Hombres
HUILA,YAGUARA,3484,3490,6974,Hombres
LA GUAJIRA,ALBANIA,8826,9357,18183,Hombres
LA GUAJIRA,BARRANCAS,12384,12373,24757,Mujeres
LA GUAJIRA,DIBULLA,10709,11678,22387,Hombres
LA GUAJIRA,DISTRACCION,4513,5191,9704,Hombres
LA GUAJIRA,EL MOLINO,3784,4043,7827,Hombres
LA GUAJIRA,FONSECA,15769,15065,30834,Mujeres
LA GUAJIRA,HATONUEVO,7567,7665,15232,Hombres
LA GUAJIRA,LA JAGUA DEL PILAR,1791,2094,3885,Hombres
LA GUAJIRA,MAICAO,69323,64220,133543,Mujeres
LA GUAJIRA,MANAURE,29042,27425,56467,Mujeres
LA GUAJIRA,RIOHACHA,75497,68002,143499,Mujeres
LA GUAJIRA,SAN JUAN DEL CESAR,17764,17262,35026,Mujeres
LA GUAJIRA,URIBIA,59780,54001,113781,Mujeres
LA GUAJIRA,URUMITA,4534,4465,8999,Mujeres
LA GUAJIRA,VILLANUEVA,10160,9559,19719,Mujeres
MAGDALENA,ALGARROBO,4889,5455,10344,Hombres
MAGDALENA,ARACATACA,14696,15285,29981,Hombres
MAGDALENA,ARIGUANI (EL DIFICIL),11132,12287,23419,Hombres
MAGDALENA,CERRO DE SAN ANTONIO,4225,4657,8882,Hombres
MAGDALENA,CHIVOLO,6720,7848,14568,Hombres
MAGDALENA,CIENAGA,45858,43730,89588,Mujeres
MAGDALENA,CONCORDIA,5332,6194,11526,Hombres
MAGDALENA,EL BANCO,24759,25787,50546,Hombres
MAGDALENA,EL PIÑON,6585,7402,13987,Hombres
MAGDALENA,EL RETEN,7659,7778,15437,Hombres
MAGDALENA,FUNDACION,28719,27722,56441,Mujeres
MAGDALENA,GUAMAL,11253,12981,24234,Hombres
MAGDALENA,NUEVA GRANADA,7046,8609,15655,Hombres
MAGDALENA,PEDRAZA,4652,5138,9790,Hombres
MAGDALENA,PIJIÑO DEL CARMEN,4192,4858,9050,Hombres
MAGDALENA,PIVIJAY,14393,15898,30291,Hombres
MAGDALENA,PLATO,20584,22064,42648,Hombres
MAGDALENA,PUEBLOVIEJO,10821,10977,21798,Hombres
MAGDALENA,REMOLINO,3420,3963,7383,Hombres
MAGDALENA,SABANAS DE SAN ANGEL,5135,6822,11957,Hombres
MAGDALENA,SALAMINA,3995,4265,8260,Hombres
MAGDALENA,SAN SEBASTIAN DE BUENAVISTA,8295,9352,17647,Hombres
MAGDALENA,SAN ZENON,4123,4677,8800,Hombres
MAGDALENA,SANTA ANA,8108,8737,16845,Hombres
MAGDALENA,SANTA BARBARA DE PINTO,4172,4727,8899,Hombres
MAGDALENA,SANTA MARTA,199277,176427,375704,Mujeres
MAGDALENA,SITIONUEVO,9676,10932,20608,Hombres
MAGDALENA,TENERIFE,5326,6076,11402,Hombres
MAGDALENA,ZAPAYAN,3862,4597,8459,Hombres
MAGDALENA,ZONA BANANERA (SEVILLA),23698,24661,48359,Hombres
META,ACACIAS,33502,34601,68103,Hombres
META,BARRANCA DE UPIA,2389,2647,5036,Hombres
META,CABUYARO,2324,2959,5283,Hombres
META,CASTILLA LA NUEVA,5955,6633,12588,Hombres
META,CUBARRAL,2715,2760,5475,Hombres
META,CUMARAL,9162,9134,18296,Mujeres
META,EL CALVARIO,760,884,1644,Hombres
META,EL CASTILLO,2795,3348,6143,Hombres
META,EL DORADO,1736,1795,3531,Hombres
META,FUENTE DE ORO,4620,5096,9716,Hombres
META,GRANADA,28126,27278,55404,Mujeres
META,GUAMAL,5870,6243,12113,Hombres
META,LA MACARENA,4332,5827,10159,Hombres
META,LEJANIAS,4063,4527,8590,Hombres
META,MAPIRIPAN,2066,3549,5615,Hombres
META,MESETAS,4047,5072,9119,Hombres
META,PUERTO CONCORDIA,2994,3978,6972,Hombres
META,PUERTO GAITAN,16778,25322,42100,Hombres
META,PUERTO LLERAS,3153,3950,7103,Hombres
META,PUERTO LOPEZ,12206,12956,25162,Hombres
META,PUERTO RICO,3919,5325,9244,Hombres
META,RESTREPO,8430,8979,17409,Hombres
META,SAN CARLOS DE GUAROA,4284,5114,9398,Hombres
META,SAN JUAN DE ARAMA,2865,3452,6317,Hombres
META,SAN JUANITO,653,734,1387,Hombres
META,SAN MARTIN DE LOS LLANOS,9331,9310,18641,Mujeres
META,URIBE,2660,3428,6088,Hombres
META,VILLAVICENCIO,201116,179088,380204,Mujeres
META,VISTA HERMOSA,6226,7790,14016,Hombres
"NARIÑO",ALBAN (SAN JOSE),3485,3519,7004,Hombres
"NARIÑO",ALDANA,3219,2877,6096,Mujeres
"NARIÑO",ANCUYA,3538,3744,7282,Hombres
"NARIÑO",ARBOLEDA (BERRUECOS),2950,3015,5965,Hombres
"NARIÑO",BARBACOAS,11167,11456,22623,Hombres
"NARIÑO",BELEN,2725,2698,5423,Mujeres
"NARIÑO",BUESACO,9147,9149,18296,Hombres
"NARIÑO",CHACHAGUI,5448,5347,10795,Mujeres
"NARIÑO",COLON (GENOVA),3393,3554,6947,Hombres
"NARIÑO",CONSACA,4533,4296,8829,Mujeres
"NARIÑO",CONTADERO,3043,2948,5991,Mujeres
"NARIÑO",CORDOBA,5697,5379,11076,Mujeres
"NARIÑO",CUASPUD (CARLOSAMA),4027,3719,7746,Mujeres
"NARIÑO",CUMBAL,13156,12480,25636,Mujeres
"NARIÑO",CUMBITARA,3167,3630,6797,Hombres
"NARIÑO",EL CHARCO,8276,9411,17687,Hombres
"NARIÑO",EL PEÑOL,2857,2904,5761,Hombres
"NARIÑO",EL ROSARIO,3513,3972,7485,Hombres
"NARIÑO",EL TABLON,5728,5992,11720,Hombres
"NARIÑO",EL TAMBO,5924,5794,11718,Mujeres
"NARIÑO",FRANCISCO PIZARRO (SALAHONDA),3298,3517,6815,Hombres
"NARIÑO",FUNES,2957,2911,5868,Mujeres
"NARIÑO",GUACHUCAL,7710,7034,14744,Mujeres
"NARIÑO",GUAITARILLA,5564,5642,11206,Hombres
"NARIÑO",GUALMATAN,2794,2542,5336,Mujeres
"NARIÑO",ILES,3715,3576,7291,Mujeres
"NARIÑO",IMUES,3374,3266,6640,Mujeres
"NARIÑO",IPIALES,52724,48093,100817,Mujeres
"NARIÑO",LA CRUZ,7112,6909,14021,Mujeres
"NARIÑO",LA FLORIDA,4671,4550,9221,Mujeres
"NARIÑO",LA LLANADA,1921,1991,3912,Hombres
"NARIÑO",LA TOLA,2726,2896,5622,Hombres
"NARIÑO",LA UNION,11699,11464,23163,Mujeres
"NARIÑO",LEIVA,3905,4543,8448,Hombres
"NARIÑO",LINARES,4232,4435,8667,Hombres
"NARIÑO",LOS ANDES (SOTOMAYOR),3772,4000,7772,Hombres
"NARIÑO",MAGUI (PAYAN),3390,3637,7027,Hombres
"NARIÑO",MALLAMA (PIEDRANCHA),3111,3196,6307,Hombres
"NARIÑO",MOSQUERA,3153,3554,6707,Hombres
"NARIÑO","NARIÑO",2493,2336,4829,Mujeres
"NARIÑO",OLAYA HERRERA,7522,7863,15385,Hombres
"NARIÑO",OSPINA,2999,2951,5950,Mujeres
"NARIÑO",PASTO,164795,142532,307327,Mujeres
"NARIÑO",POLICARPA,5442,6044,11486,Hombres
"NARIÑO",POTOSI,5065,4855,9920,Mujeres
"NARIÑO",PROVIDENCIA,2392,2386,4778,Mujeres
"NARIÑO",PUERRES,4041,3748,7789,Mujeres
"NARIÑO",PUPIALES,7931,7388,15319,Mujeres
"NARIÑO",RICAURTE,8745,9262,18007,Hombres
"NARIÑO",ROBERTO PAYAN (SAN JOSE),4521,5042,9563,Hombres
"NARIÑO",SAMANIEGO,11490,11553,23043,Hombres
"NARIÑO",SAN BERNARDO,3301,3380,6681,Hombres
"NARIÑO",SAN LORENZO,6456,7018,13474,Hombres
"NARIÑO",SAN PABLO,6117,5783,11900,Mujeres
"NARIÑO",SAN PEDRO DE CARTAGO,2805,2864,5669,Hombres
"NARIÑO",SANDONA,8629,8310,16939,Mujeres
"NARIÑO",SANTA BARBARA (ISCUANDE),3493,3964,7457,Hombres
"NARIÑO",SANTACRUZ (GUACHAVES),3538,3697,7235,Hombres
"NARIÑO",SAPUYES,3019,2743,5762,Mujeres
"NARIÑO",TAMINANGO,6983,6984,13967,Hombres
"NARIÑO",TANGUA,5002,4965,9967,Mujeres
"NARIÑO",TUMACO,68280,63952,132232,Mujeres
"NARIÑO",TUQUERRES,18386,17491,35877,Mujeres
"NARIÑO",YACUANQUER,4604,4221,8825,Mujeres
NORTE DE SAN,ABREGO,11875,12665,24540,Hombres
NORTE DE SAN,ARBOLEDAS,3413,4061,7474,Hombres
NORTE DE SAN,BOCHALEMA,3857,4022,7879,Hombres
NORTE DE SAN,BUCARASICA,1790,2366,4156,Hombres
NORTE DE SAN,CACHIRA,3512,3999,7511,Hombres
NORTE DE SAN,CACOTA,1138,1336,2474,Hombres
NORTE DE SAN,CHINACOTA,7671,7401,15072,Mujeres
NORTE DE SAN,CHITAGA,4281,4690,8971,Hombres
NORTE DE SAN,CONVENCION,7614,9143,16757,Hombres
NORTE DE SAN,CUCUTA,329975,288490,618465,Mujeres
NORTE DE SAN,CUCUTILLA,3078,3559,6637,Hombres
NORTE DE SAN,DURANIA,3331,3578,6909,Hombres
NORTE DE SAN,EL CARMEN,4738,5924,10662,Hombres
NORTE DE SAN,EL TARRA,6719,8237,14956,Hombres
NORTE DE SAN,EL ZULIA,11513,11876,23389,Hombres
NORTE DE SAN,GRAMALOTE,2688,2893,5581,Hombres
NORTE DE SAN,HACARI,3428,4438,7866,Hombres
NORTE DE SAN,HERRAN,2497,2768,5265,Hombres
NORTE DE SAN,LA ESPERANZA,4241,4999,9240,Hombres
NORTE DE SAN,LA PLAYA,3217,3902,7119,Hombres
NORTE DE SAN,LABATECA,2606,2978,5584,Hombres
NORTE DE SAN,LOS PATIOS,42008,39720,81728,Mujeres
NORTE DE SAN,LOURDES,1585,1966,3551,Hombres
NORTE DE SAN,MUTISCUA,1562,1693,3255,Hombres
NORTE DE SAN,OCAÑA,44688,39519,84207,Mujeres
NORTE DE SAN,PAMPLONA,23919,23030,46949,Mujeres
NORTE DE SAN,PAMPLONITA,1976,2209,4185,Hombres
NORTE DE SAN,PUERTO SANTANDER,9668,8879,18547,Mujeres
NORTE DE SAN,RAGONVALIA,4999,5005,10004,Hombres
NORTE DE SAN,SALAZAR,4531,5110,9641,Hombres
NORTE DE SAN,SAN CALIXTO,3400,4422,7822,Hombres
NORTE DE SAN,SAN CAYETANO,4639,5174,9813,Hombres
NORTE DE SAN,SANTIAGO,2305,2729,5034,Hombres
NORTE DE SAN,SARDINATA,9248,11029,20277,Hombres
NORTE DE SAN,SILOS,2161,2408,4569,Hombres
NORTE DE SAN,TEORAMA,4914,6205,11119,Hombres
NORTE DE SAN,TIBU,19413,23548,42961,Hombres
NORTE DE SAN,TOLEDO,6127,6833,12960,Hombres
NORTE DE SAN,VILLA CARO,1947,2025,3972,Hombres
NORTE DE SAN,VILLA DEL ROSARIO,52361,47301,99662,Mujeres
PUTUMAYO,COLON,2342,2220,4562,Mujeres
PUTUMAYO,MOCOA,20858,18872,39730,Mujeres
PUTUMAYO,ORITO,14304,14831,29135,Hombres
PUTUMAYO,PUERTO ASIS,24012,24529,48541,Hombres
PUTUMAYO,PUERTO CAICEDO,4686,5193,9879,Hombres
PUTUMAYO,PUERTO GUZMAN,5347,6878,12225,Hombres
PUTUMAYO,PUERTO LEGUIZAMO,7088,8470,15558,Hombres
PUTUMAYO,SAN FRANCISCO,2471,2388,4859,Mujeres
PUTUMAYO,SAN MIGUEL (LA DORADA),6445,7019,13464,Hombres
PUTUMAYO,SANTIAGO,3339,3113,6452,Mujeres
PUTUMAYO,SIBUNDOY,5861,5246,11107,Mujeres
PUTUMAYO,VALLE DEL GUAMUEZ (LA HORMIGA),13180,14001,27181,Hombres
PUTUMAYO,VILLAGARZON,9156,9864,19020,Hombres
QUINDIO,ARMENIA,141253,125678,266931,Mujeres
QUINDIO,BUENAVISTA,1266,1480,2746,Hombres
QUINDIO,CALARCA,32188,30168,62356,Mujeres
QUINDIO,CIRCASIA,12511,11426,23937,Mujeres
QUINDIO,CORDOBA,2631,2906,5537,Hombres
QUINDIO,FILANDIA,5308,5323,10631,Hombres
QUINDIO,GENOVA,3401,4052,7453,Hombres
QUINDIO,LA TEBAIDA,15376,14454,29830,Mujeres
QUINDIO,MONTENEGRO,17592,17602,35194,Hombres
QUINDIO,PIJAO,2764,3360,6124,Hombres
QUINDIO,QUIMBAYA,15602,15356,30958,Mujeres
QUINDIO,SALENTO,2999,3105,6104,Hombres
RISARALDA,APIA,4984,5717,10701,Hombres
RISARALDA,BALBOA,2686,3163,5849,Hombres
RISARALDA,BELEN DE UMBRIA,10648,11743,22391,Hombres
RISARALDA,DOSQUEBRADAS,92657,79090,171747,Mujeres
RISARALDA,GUATICA,5068,5637,10705,Hombres
RISARALDA,LA CELIA,3093,3695,6788,Hombres
RISARALDA,LA VIRGINIA,17371,16365,33736,Mujeres
RISARALDA,MARSELLA,7678,8334,16012,Hombres
RISARALDA,MISTRATO,5927,6359,12286,Hombres
RISARALDA,PEREIRA,229648,203990,433638,Mujeres
RISARALDA,PUEBLO RICO,5337,5612,10949,Hombres
RISARALDA,QUINCHIA,10233,10820,21053,Hombres
RISARALDA,SANTA ROSA DE CABAL,33553,31902,65455,Mujeres
RISARALDA,SANTUARIO,5743,6550,12293,Hombres
SAN ANDRES,PROVIDENCIA,2267,2161,4428,Mujeres
SAN ANDRES,SAN ANDRES,24417,22540,46957,Mujeres
SANTANDER,AGUADA,710,826,1536,Hombres
SANTANDER,ALBANIA,1618,1876,3494,Hombres
SANTANDER,ARATOCA,3333,3582,6915,Hombres
SANTANDER,BARBOSA,13248,12716,25964,Mujeres
SANTANDER,BARICHARA,3574,3444,7018,Mujeres
SANTANDER,BARRANCABERMEJA,93545,88331,181876,Mujeres
SANTANDER,BETULIA,2031,2463,4494,Hombres
SANTANDER,BOLIVAR,3886,4376,8262,Hombres
SANTANDER,BUCARAMANGA,274749,241723,516472,Mujeres
SANTANDER,CABRERA,846,897,1743,Hombres
SANTANDER,CALIFORNIA,826,892,1718,Hombres
SANTANDER,CAPITANEJO,2479,2596,5075,Hombres
SANTANDER,CARCASI,1714,2056,3770,Hombres
SANTANDER,CEPITA,939,1054,1993,Hombres
SANTANDER,CERRITO,2490,2825,5315,Hombres
SANTANDER,CHARALA,4831,5102,9933,Hombres
SANTANDER,CHARTA,1573,1721,3294,Hombres
SANTANDER,CHIMA,1162,1382,2544,Hombres
SANTANDER,CHIPATA,1965,2321,4286,Hombres
SANTANDER,CIMITARRA,12935,16144,29079,Hombres
SANTANDER,CONCEPCION,2521,2682,5203,Hombres
SANTANDER,CONFINES,1151,1467,2618,Hombres
SANTANDER,CONTRATACION,1530,1544,3074,Hombres
SANTANDER,COROMORO,1978,2293,4271,Hombres
SANTANDER,CURITI,4709,4789,9498,Hombres
SANTANDER,EL CARMEN,5140,6319,11459,Hombres
SANTANDER,EL GUACAMAYO,733,885,1618,Hombres
SANTANDER,EL PEÑON,1674,2060,3734,Hombres
SANTANDER,EL PLAYON,5831,6578,12409,Hombres
SANTANDER,ENCINO,1017,1179,2196,Hombres
SANTANDER,ENCISO,1585,1810,3395,Hombres
SANTANDER,FLORIAN,2754,3241,5995,Hombres
SANTANDER,FLORIDABLANCA,110970,93827,204797,Mujeres
SANTANDER,GALAN,1231,1377,2608,Hombres
SANTANDER,GAMBITA,1506,1859,3365,Hombres
SANTANDER,GIRON,64977,58399,123376,Mujeres
SANTANDER,GUACA,2543,2973,5516,Hombres
SANTANDER,GUADALUPE,2061,2339,4400,Hombres
SANTANDER,GUAPOTA,905,1030,1935,Hombres
SANTANDER,GUAVATA,2140,2450,4590,Hombres
SANTANDER,GUEPSA,2134,2230,4364,Hombres
SANTANDER,HATO,930,1035,1965,Hombres
SANTANDER,JESUS MARIA,1642,1792,3434,Hombres
SANTANDER,JORDAN,606,684,1290,Hombres
SANTANDER,LA BELLEZA,2790,3134,5924,Hombres
SANTANDER,LA PAZ,1905,2260,4165,Hombres
SANTANDER,LANDAZURI,4473,5476,9949,Hombres
SANTANDER,LEBRIJA,16260,17759,34019,Hombres
SANTANDER,LOS SANTOS,4522,4998,9520,Hombres
SANTANDER,MACARAVITA,1077,1264,2341,Hombres
SANTANDER,MALAGA,8570,7787,16357,Mujeres
SANTANDER,MATANZA,2334,2769,5103,Hombres
SANTANDER,MOGOTES,3804,4161,7965,Hombres
SANTANDER,MOLAGAVITA,1738,2049,3787,Hombres
SANTANDER,OCAMONTE,1868,2142,4010,Hombres
SANTANDER,OIBA,4525,4866,9391,Hombres
SANTANDER,ONZAGA,1750,2005,3755,Hombres
SANTANDER,PALMAR,754,789,1543,Hombres
SANTANDER,PALMAS DEL SOCORRO,1098,1340,2438,Hombres
SANTANDER,PARAMO,1797,2002,3799,Hombres
SANTANDER,PIEDECUESTA,61275,56810,118085,Mujeres
SANTANDER,PINCHOTE,1725,1749,3474,Hombres
SANTANDER,PUENTE NACIONAL,6315,6627,12942,Hombres
SANTANDER,PUERTO PARRA,2719,3354,6073,Hombres
SANTANDER,PUERTO WILCHES,11533,13069,24602,Hombres
SANTANDER,RIONEGRO,10852,13066,23918,Hombres
SANTANDER,SABANA DE TORRES,11055,12032,23087,Hombres
SANTANDER,SAN ANDRES,3200,3690,6890,Hombres
SANTANDER,SAN BENITO,1315,1638,2953,Hombres
SANTANDER,SAN GIL,23259,20821,44080,Mujeres
SANTANDER,SAN JOAQUIN,1064,1203,2267,Hombres
SANTANDER,SAN JOSE DE MIRANDA,2001,2190,4191,Hombres
SANTANDER,SAN MIGUEL,1018,1234,2252,Hombres
SANTANDER,SAN VICENTE DE CHUCURI,11411,13433,24844,Hombres
SANTANDER,SANTA BARBARA,1008,1264,2272,Hombres
SANTANDER,SANTA HELENA DEL OPON,1482,1920,3402,Hombres
SANTANDER,SIMACOTA,2797,3374,6171,Hombres
SANTANDER,SOCORRO,12927,11901,24828,Mujeres
SANTANDER,SUAITA,3947,4503,8450,Hombres
SANTANDER,SUCRE,2747,3021,5768,Hombres
SANTANDER,SURATA,1647,1832,3479,Hombres
SANTANDER,TONA,2422,2855,5277,Hombres
SANTANDER,VALLE DE SAN JOSE,2435,2553,4988,Hombres
SANTANDER,VELEZ,8324,8387,16711,Hombres
SANTANDER,VETAS,727,750,1477,Hombres
SANTANDER,VILLANUEVA,3471,3233,6704,Mujeres
SANTANDER,ZAPATOCA,3927,3861,7788,Mujeres
SUCRE,BUENAVISTA,4766,5193,9959,Hombres
SUCRE,CAIMITO,4662,5279,9941,Hombres
SUCRE,CHALAN,2150,2589,4739,Hombres
SUCRE,COLOSO (RICAURTE),3700,4275,7975,Hombres
SUCRE,COROZAL,25598,23569,49167,Mujeres
SUCRE,COVEÑAS,6253,6966,13219,Hombres
SUCRE,EL ROBLE,4157,4800,8957,Hombres
SUCRE,GALERAS (NUEVA GRANADA),8610,9238,17848,Hombres
SUCRE,GUARANDA,6630,7851,14481,Hombres
SUCRE,LA UNION,5047,5450,10497,Hombres
SUCRE,LOS PALMITOS,9573,9879,19452,Hombres
SUCRE,MAJAGUAL,12949,15459,28408,Hombres
SUCRE,MORROA,7337,7658,14995,Hombres
SUCRE,OVEJAS,10755,12039,22794,Hombres
SUCRE,PALMITO,5605,6035,11640,Hombres
SUCRE,SAMPUES,17096,17766,34862,Hombres
SUCRE,SAN BENITO ABAD,9344,10885,20229,Hombres
SUCRE,SAN JUAN DE BETULIA (BETULIA),5856,6091,11947,Hombres
SUCRE,SAN MARCOS,23047,24042,47089,Hombres
SUCRE,SAN ONOFRE,22138,24087,46225,Hombres
SUCRE,SAN PEDRO,8211,8730,16941,Hombres
SUCRE,SINCE,13371,14036,27407,Hombres
SUCRE,SINCELEJO,113745,101605,215350,Mujeres
SUCRE,SUCRE,9540,11857,21397,Hombres
SUCRE,TOLU,12599,12371,24970,Mujeres
SUCRE,TOLUVIEJO,9919,10624,20543,Hombres
TOLIMA,ALPUJARRA,1787,1977,3764,Hombres
TOLIMA,ALVARADO,4045,4544,8589,Hombres
TOLIMA,AMBALEMA,3318,3574,6892,Hombres
TOLIMA,ANZOATEGUI,3690,4640,8330,Hombres
TOLIMA,ARMERO (GUAYABAL),5139,5425,10564,Hombres
TOLIMA,ATACO,7155,8955,16110,Hombres
TOLIMA,CAJAMARCA,7984,9101,17085,Hombres
TOLIMA,CARMEN DE APICALA,4626,4718,9344,Hombres
TOLIMA,CASABIANCA,2493,3069,5562,Hombres
TOLIMA,CHAPARRAL,19647,20657,40304,Hombres
TOLIMA,COELLO,3846,4276,8122,Hombres
TOLIMA,COYAIMA,8658,9186,17844,Hombres
TOLIMA,CUNDAY,3269,3910,7179,Hombres
TOLIMA,DOLORES,3236,3836,7072,Hombres
TOLIMA,ESPINAL,31915,29220,61135,Mujeres
TOLIMA,FALAN,2874,3355,6229,Hombres
TOLIMA,FLANDES,9983,8658,18641,Mujeres
TOLIMA,FRESNO,13005,14400,27405,Hombres
TOLIMA,GUAMO,13352,12795,26147,Mujeres
TOLIMA,HERVEO,2662,3093,5755,Hombres
TOLIMA,HONDA,11519,11391,22910,Mujeres
TOLIMA,IBAGUE,233589,203411,437000,Mujeres
TOLIMA,ICONONZO,4232,4778,9010,Hombres
TOLIMA,LERIDA,7840,7555,15395,Mujeres
TOLIMA,LIBANO,16501,17158,33659,Hombres
TOLIMA,MARIQUITA,15026,14637,29663,Mujeres
TOLIMA,MELGAR,15556,14989,30545,Mujeres
TOLIMA,MURILLO,1748,2188,3936,Hombres
TOLIMA,"NATAGAIMA",7411,8051,15462,Hombres
TOLIMA,ORTEGA,11083,12747,23830,Hombres
TOLIMA,PALOCABILDO,3844,4319,8163,Hombres
TOLIMA,PIEDRAS,2770,3035,5805,Hombres
TOLIMA,PLANADAS,10351,12499,22850,Hombres
TOLIMA,PRADO,3830,4248,8078,Hombres
TOLIMA,PURIFICACION,10340,10243,20583,Mujeres
TOLIMA,RIOBLANCO,7840,9799,17639,Hombres
TOLIMA,RONCESVALLES,2043,2457,4500,Hombres
TOLIMA,ROVIRA,9602,11166,20768,Hombres
TOLIMA,SALDAÑA,6369,6404,12773,Hombres
TOLIMA,SAN ANTONIO,4847,5762,10609,Hombres
TOLIMA,SAN LUIS,5735,6080,11815,Hombres
TOLIMA,SANTA ISABEL,2626,3284,5910,Hombres
TOLIMA,SUAREZ,2126,2383,4509,Hombres
TOLIMA,VALLE DE SAN JUAN,2289,2705,4994,Hombres
TOLIMA,VENADILLO,5851,6164,12015,Hombres
TOLIMA,VILLAHERMOSA,3178,3910,7088,Hombres
TOLIMA,VILLARRICA,2219,2816,5035,Hombres
VALLE,ALCALA,5917,6144,12061,Hombres
VALLE,ANDALUCIA,10108,9642,19750,Mujeres
VALLE,ANSERMANUEVO,9106,10212,19318,Hombres
VALLE,ARGELIA,2822,3373,6195,Hombres
VALLE,BOLIVAR,6465,6874,13339,Hombres
VALLE,BUENAVENTURA,123750,109447,233197,Mujeres
VALLE,BUGA,56777,50099,106876,Mujeres
VALLE,BUGALAGRANDE,10339,9956,20295,Mujeres
VALLE,CAICEDONIA,13668,14397,28065,Hombres
VALLE,CALI,972142,815282,1787424,Mujeres
VALLE,CALIMA (DARIEN),7349,7464,14813,Hombres
VALLE,CANDELARIA,39678,36703,76381,Mujeres
VALLE,CARTAGO,63802,54931,118733,Mujeres
VALLE,DAGUA,18040,18832,36872,Hombres
VALLE,EL AGUILA,3439,4444,7883,Hombres
VALLE,EL CAIRO,2949,3776,6725,Hombres
VALLE,EL CERRITO,27687,26543,54230,Mujeres
VALLE,EL DOVIO,4902,5287,10189,Hombres
VALLE,FLORIDA,27470,26198,53668,Mujeres
VALLE,GINEBRA,9218,8953,18171,Mujeres
VALLE,GUACARI,15255,14179,29434,Mujeres
VALLE,JAMUNDI,58713,53639,112352,Mujeres
VALLE,LA CUMBRE,6510,6985,13495,Hombres
VALLE,LA UNION,14517,13101,27618,Mujeres
VALLE,LA VICTORIA,6070,5708,11778,Mujeres
VALLE,OBANDO,5694,5616,11310,Mujeres
VALLE,PALMIRA,150092,129704,279796,Mujeres
VALLE,PRADERA,22043,19869,41912,Mujeres
VALLE,RESTREPO,7906,8110,16016,Hombres
VALLE,RIOFRIO,7657,8240,15897,Hombres
VALLE,ROLDANILLO,16085,14174,30259,Mujeres
VALLE,SAN PEDRO,7478,7545,15023,Hombres
VALLE,SEVILLA,18729,19185,37914,Hombres
VALLE,TORO,6514,6335,12849,Mujeres
VALLE,TRUJILLO,7926,8671,16597,Hombres
VALLE,TULUA,91876,78795,170671,Mujeres
VALLE,ULLOA,2379,2565,4944,Hombres
VALLE,VERSALLES,3723,4104,7827,Hombres
VALLE,VIJES,5415,5488,10903,Hombres
VALLE,YOTOCO,7533,7465,14998,Mujeres
VALLE,YUMBO,54525,50245,104770,Mujeres
VALLE,ZARZAL,20508,18313,38821,Mujeres
VAUPES,BUENOS AIRES (PACOA),477,601,1078,Hombres
VAUPES,CARURU,742,1002,1744,Hombres
VAUPES,MITU,8184,9447,17631,Hombres
VAUPES,MORICHAL (PAPUNAGUA),69,114,183,Hombres
VAUPES,TARAIRA,746,977,1723,Hombres
VAUPES,YAVARATE,430,593,1023,Hombres
VICHADA,CUMARIBO,10137,12600,22737,Hombres
VICHADA,LA PRIMAVERA,3254,3990,7244,Hombres
VICHADA,PUERTO CARREÑO,9538,10434,19972,Hombres
VICHADA,SANTA ROSALIA,1505,1761,3266,Hombres
